#################################
##                           ####
##                           ####
##                           ####
##                           ####
##                           ####
##                           ####
##                           ####
##                           ####
##                           ####
##                           ####
##                           ####
##                           ####
                                #
P                               #
##                           ####
##                           ####
##                           ####
##                           ####
##                           ####
##                           ####
##                           ####
##                           ####
##                           ####
##                           ####
##                           ####
##                           ####
#################################
#################################